WWWWWWWWWWWWWWWWWWWWWWWW
WOOOOOOOOOOOOOWOWOOOOOOW
WKWWWOWOWOWWWOOOWOWOWOWW
WOWWWOWOWOWWWOWOWOOOOOOW
WOOOOOOOOOOOOOWOWOWOWOWW
WWWWWWWOWWWWWWWOWOOOOOKW
WWWOOOOOOOOOOOOOWOWOWOWW
WOOOWWWWWWWWOWWOWOOOOOOW
WWWOOOOOOOWOOOWOWOWOWOWW
WWWOWWWWWOOOOOOOOOOOOOOW
WKWOWOOKWOWOOOWOWOWOWOWW
WOWOWOWWWOWWOWWOWOOOOOOW
WOWOOOWWWOWWOWWOWOWOWOWW
WOWOWOOOOOOOOOOOWOOOOOOW
WOOOWOWWWOWWWWWOWOWOWOWW
WOWWWOWOOOOOOOWOWOOOOOOW
WOWWWOWOOOOOOOOOWOWOWOWW
WOWWWOWOOOOOOOWOWOOOKOOW
WOOOOOOOOOOOOOWOWOWOWOWW
WWWWWWWWWWWWWWWWWWWWWWWW